11111111111111111111
10000000C00000000001
100P0C00000C00000001
1000000111100000C001
10C00001E0100000001
1000000100100C000001
100C000100100000001
1000C00000000000C001
10000000C0000C000001
11111111111111111111