1111111111111111111111111
1P00C01000C000100000C0001
1010101011111101110111101
101010101000000100000C101
101010101011110111111101
10101C1000000000C0000001
101010101111110111011111
101010101000000100010001
101010101011110111010101
1010101010C0000000010101
101010101111110111110101
1E1010100000000100000101
101110111111110111110101
1C0000000C00000000C00001
1111111111111111111111111