1111111
11CP1E1
1111111
1111111